id,name,type,hp,attack,defense,speed,total,legendary
1,Bulbasaur,Grass,45,49,49,45,188,0
2,Ivysaur,Grass,60,62,63,60,245,0
3,Venusaur,Grass,80,82,83,80,325,0
4,VenusaurMega Venusaur,Grass,80,100,123,80,383,0
5,Charmander,Fire,39,52,43,65,199,0
6,Charmeleon,Fire,58,64,58,80,260,0
7,Charizard,Fire,78,84,78,100,340,0
8,CharizardMega Charizard X,Fire,78,130,111,100,419,0
9,CharizardMega Charizard Y,Fire,78,104,78,100,360,0
10,Squirtle,Water,44,48,65,43,200,0
11,Wartortle,Water,59,63,80,58,260,0
12,Blastoise,Water,79,83,100,78,340,0
13,BlastoiseMega Blastoise,Water,79,103,120,78,380,0
14,Caterpie,Bug,45,30,35,45,155,0
15,Metapod,Bug,50,20,55,30,155,0
16,Butterfree,Bug,60,45,50,70,225,0
17,Weedle,Bug,40,35,30,50,155,0
18,Kakuna,Bug,45,25,50,35,155,0
19,Beedrill,Bug,65,90,40,75,270,0
20,BeedrillMega Beedrill,Bug,65,150,40,145,400,0
21,Pidgey,Normal,40,45,40,56,181,0
22,Pidgeotto,Normal,63,60,55,71,249,0
23,Pidgeot,Normal,83,80,75,101,339,0
24,PidgeotMega Pidgeot,Normal,83,80,80,121,364,0
25,Rattata,Normal,30,56,35,72,193,0
26,Raticate,Normal,55,81,60,97,293,0
27,Spearow,Normal,40,60,30,70,200,0
28,Fearow,Normal,65,90,65,100,320,0
29,Ekans,Poison,35,60,44,55,194,0
30,Arbok,Poison,60,85,69,80,294,0
31,Pikachu,Electric,35,55,40,90,220,0
32,Raichu,Electric,60,90,55,110,315,0
33,Sandshrew,Ground,50,75,85,40,250,0
34,Sandslash,Ground,75,100,110,65,350,0
35,Nidoran♀,Poison,55,47,52,41,195,0
36,Nidorina,Poison,70,62,67,56,255,0
37,Nidoqueen,Poison,90,92,87,76,345,0
38,Nidoran♂,Poison,46,57,40,50,193,0
39,Nidorino,Poison,61,72,57,65,255,0
40,Nidoking,Poison,81,102,77,85,345,0
41,Clefairy,Fairy,70,45,48,35,198,0
42,Clefable,Fairy,95,70,73,60,298,0
43,Vulpix,Fire,38,41,40,65,184,0
44,Ninetales,Fire,73,76,75,100,324,0
45,Jigglypuff,Normal,115,45,20,20,200,0
46,Wigglytuff,Normal,140,70,45,45,300,0
47,Zubat,Poison,40,45,35,55,175,0
48,Golbat,Poison,75,80,70,90,315,0
49,Oddish,Grass,45,50,55,30,180,0
50,Gloom,Grass,60,65,70,40,235,0
51,Vileplume,Grass,75,80,85,50,290,0
52,Paras,Bug,35,70,55,25,185,0
53,Parasect,Bug,60,95,80,30,265,0
54,Venonat,Bug,60,55,50,45,210,0
55,Venomoth,Bug,70,65,60,90,285,0
56,Diglett,Ground,10,55,25,95,185,0
57,Dugtrio,Ground,35,80,50,120,285,0
58,Meowth,Normal,40,45,35,90,210,0
59,Persian,Normal,65,70,60,115,310,0
60,Psyduck,Water,50,52,48,55,205,0
61,Golduck,Water,80,82,78,85,325,0
62,Mankey,Fighting,40,80,35,70,225,0
63,Primeape,Fighting,65,105,60,95,325,0
64,Growlithe,Fire,55,70,45,60,230,0
65,Arcanine,Fire,90,110,80,95,375,0
66,Poliwag,Water,40,50,40,90,220,0
67,Poliwhirl,Water,65,65,65,90,285,0
68,Poliwrath,Water,90,95,95,70,350,0
69,Abra,Psychic,25,20,15,90,150,0
70,Kadabra,Psychic,40,35,30,105,210,0
71,Alakazam,Psychic,55,50,45,120,270,0
72,AlakazamMega Alakazam,Psychic,55,50,65,150,320,0
73,Machop,Fighting,70,80,50,35,235,0
74,Machoke,Fighting,80,100,70,45,295,0
75,Machamp,Fighting,90,130,80,55,355,0
76,Bellsprout,Grass,50,75,35,40,200,0
77,Weepinbell,Grass,65,90,50,55,260,0
78,Victreebel,Grass,80,105,65,70,320,0
79,Tentacool,Water,40,40,35,70,185,0
80,Tentacruel,Water,80,70,65,100,315,0
81,Geodude,Rock,40,80,100,20,240,0
82,Graveler,Rock,55,95,115,35,300,0
83,Golem,Rock,80,120,130,45,375,0
84,Ponyta,Fire,50,85,55,90,280,0
85,Rapidash,Fire,65,100,70,105,340,0
86,Slowpoke,Water,90,65,65,15,235,0
87,Slowbro,Water,95,75,110,30,310,0
88,SlowbroMega Slowbro,Water,95,75,180,30,380,0
89,Magnemite,Electric,25,35,70,45,175,0
90,Magneton,Electric,50,60,95,70,275,0
91,Farfetch'd,Normal,52,65,55,60,232,0
92,Doduo,Normal,35,85,45,75,240,0
93,Dodrio,Normal,60,110,70,100,340,0
94,Seel,Water,65,45,55,45,210,0
95,Dewgong,Water,90,70,80,70,310,0
96,Grimer,Poison,80,80,50,25,235,0
97,Muk,Poison,105,105,75,50,335,0
98,Shellder,Water,30,65,100,40,235,0
99,Cloyster,Water,50,95,180,70,395,0
100,Gastly,Ghost,30,35,30,80,175,0
101,Haunter,Ghost,45,50,45,95,235,0
102,Gengar,Ghost,60,65,60,110,295,0
103,GengarMega Gengar,Ghost,60,65,80,130,335,0
104,Onix,Rock,35,45,160,70,310,0
105,Drowzee,Psychic,60,48,45,42,195,0
106,Hypno,Psychic,85,73,70,67,295,0
107,Krabby,Water,30,105,90,50,275,0
108,Kingler,Water,55,130,115,75,375,0
109,Voltorb,Electric,40,30,50,100,220,0
110,Electrode,Electric,60,50,70,140,320,0
111,Exeggcute,Grass,60,40,80,40,220,0
112,Exeggutor,Grass,95,95,85,55,330,0
113,Cubone,Ground,50,50,95,35,230,0
114,Marowak,Ground,60,80,110,45,295,0
115,Hitmonlee,Fighting,50,120,53,87,310,0
116,Hitmonchan,Fighting,50,105,79,76,310,0
117,Lickitung,Normal,90,55,75,30,250,0
118,Koffing,Poison,40,65,95,35,235,0
119,Weezing,Poison,65,90,120,60,335,0
120,Rhyhorn,Ground,80,85,95,25,285,0
121,Rhydon,Ground,105,130,120,40,395,0
122,Chansey,Normal,250,5,5,50,310,0
123,Tangela,Grass,65,55,115,60,295,0
124,Kangaskhan,Normal,105,95,80,90,370,0
125,KangaskhanMega Kangaskhan,Normal,105,125,100,100,430,0
126,Horsea,Water,30,40,70,60,200,0
127,Seadra,Water,55,65,95,85,300,0
128,Goldeen,Water,45,67,60,63,235,0
129,Seaking,Water,80,92,65,68,305,0
130,Staryu,Water,30,45,55,85,215,0
131,Starmie,Water,60,75,85,115,335,0
132,Mr. Mime,Psychic,40,45,65,90,240,0
133,Scyther,Bug,70,110,80,105,365,0
134,Jynx,Ice,65,50,35,95,245,0
135,Electabuzz,Electric,65,83,57,105,310,0
136,Magmar,Fire,65,95,57,93,310,0
137,Pinsir,Bug,65,125,100,85,375,0
138,PinsirMega Pinsir,Bug,65,155,120,105,445,0
139,Tauros,Normal,75,100,95,110,380,0
140,Magikarp,Water,20,10,55,80,165,0
141,Gyarados,Water,95,125,79,81,380,0
142,GyaradosMega Gyarados,Water,95,155,109,81,440,0
143,Lapras,Water,130,85,80,60,355,0
144,Ditto,Normal,48,48,48,48,192,0
145,Eevee,Normal,55,55,50,55,215,0
146,Vaporeon,Water,130,65,60,65,320,0
147,Jolteon,Electric,65,65,60,130,320,0
148,Flareon,Fire,65,130,60,65,320,0
149,Porygon,Normal,65,60,70,40,235,0
150,Omanyte,Rock,35,40,100,35,210,0
151,Omastar,Rock,70,60,125,55,310,0
152,Kabuto,Rock,30,80,90,55,255,0
153,Kabutops,Rock,60,115,105,80,360,0
154,Aerodactyl,Rock,80,105,65,130,380,0
155,AerodactylMega Aerodactyl,Rock,80,135,85,150,450,0
156,Snorlax,Normal,160,110,65,30,365,0
157,Articuno,Ice,90,85,100,85,360,1
158,Zapdos,Electric,90,90,85,100,365,1
159,Moltres,Fire,90,100,90,90,370,1
160,Dratini,Dragon,41,64,45,50,200,0
161,Dragonair,Dragon,61,84,65,70,280,0
162,Dragonite,Dragon,91,134,95,80,400,0
163,Mewtwo,Psychic,106,110,90,130,436,1
164,MewtwoMega Mewtwo X,Psychic,106,190,100,130,526,1
165,MewtwoMega Mewtwo Y,Psychic,106,150,70,140,466,1
166,Mew,Psychic,100,100,100,100,400,0
167,Chikorita,Grass,45,49,65,45,204,0
168,Bayleef,Grass,60,62,80,60,262,0
169,Meganium,Grass,80,82,100,80,342,0
170,Cyndaquil,Fire,39,52,43,65,199,0
171,Quilava,Fire,58,64,58,80,260,0
172,Typhlosion,Fire,78,84,78,100,340,0
173,Totodile,Water,50,65,64,43,222,0
174,Croconaw,Water,65,80,80,58,283,0
175,Feraligatr,Water,85,105,100,78,368,0
176,Sentret,Normal,35,46,34,20,135,0
177,Furret,Normal,85,76,64,90,315,0
178,Hoothoot,Normal,60,30,30,50,170,0
179,Noctowl,Normal,100,50,50,70,270,0
180,Ledyba,Bug,40,20,30,55,145,0
181,Ledian,Bug,55,35,50,85,225,0
182,Spinarak,Bug,40,60,40,30,170,0
183,Ariados,Bug,70,90,70,40,270,0
184,Crobat,Poison,85,90,80,130,385,0
185,Chinchou,Water,75,38,38,67,218,0
186,Lanturn,Water,125,58,58,67,308,0
187,Pichu,Electric,20,40,15,60,135,0
188,Cleffa,Fairy,50,25,28,15,118,0
189,Igglybuff,Normal,90,30,15,15,150,0
190,Togepi,Fairy,35,20,65,20,140,0
191,Togetic,Fairy,55,40,85,40,220,0
192,Natu,Psychic,40,50,45,70,205,0
193,Xatu,Psychic,65,75,70,95,305,0
194,Mareep,Electric,55,40,40,35,170,0
195,Flaaffy,Electric,70,55,55,45,225,0
196,Ampharos,Electric,90,75,85,55,305,0
197,AmpharosMega Ampharos,Electric,90,95,105,45,335,0
198,Bellossom,Grass,75,80,95,50,300,0
199,Marill,Water,70,20,50,40,180,0
200,Azumarill,Water,100,50,80,50,280,0
201,Sudowoodo,Rock,70,100,115,30,315,0
202,Politoed,Water,90,75,75,70,310,0
203,Hoppip,Grass,35,35,40,50,160,0
204,Skiploom,Grass,55,45,50,80,230,0
205,Jumpluff,Grass,75,55,70,110,310,0
206,Aipom,Normal,55,70,55,85,265,0
207,Sunkern,Grass,30,30,30,30,120,0
208,Sunflora,Grass,75,75,55,30,235,0
209,Yanma,Bug,65,65,45,95,270,0
210,Wooper,Water,55,45,45,15,160,0
211,Quagsire,Water,95,85,85,35,300,0
212,Espeon,Psychic,65,65,60,110,300,0
213,Umbreon,Dark,95,65,110,65,335,0
214,Murkrow,Dark,60,85,42,91,278,0
215,Slowking,Water,95,75,80,30,280,0
216,Misdreavus,Ghost,60,60,60,85,265,0
217,Unown,Psychic,48,72,48,48,216,0
218,Wobbuffet,Psychic,190,33,58,33,314,0
219,Girafarig,Normal,70,80,65,85,300,0
220,Pineco,Bug,50,65,90,15,220,0
221,Forretress,Bug,75,90,140,40,345,0
222,Dunsparce,Normal,100,70,70,45,285,0
223,Gligar,Ground,65,75,105,85,330,0
224,Steelix,Steel,75,85,200,30,390,0
225,SteelixMega Steelix,Steel,75,125,230,30,460,0
226,Snubbull,Fairy,60,80,50,30,220,0
227,Granbull,Fairy,90,120,75,45,330,0
228,Qwilfish,Water,65,95,75,85,320,0
229,Scizor,Bug,70,130,100,65,365,0
230,ScizorMega Scizor,Bug,70,150,140,75,435,0
231,Shuckle,Bug,20,10,230,5,265,0
232,Heracross,Bug,80,125,75,85,365,0
233,HeracrossMega Heracross,Bug,80,185,115,75,455,0
234,Sneasel,Dark,55,95,55,115,320,0
235,Teddiursa,Normal,60,80,50,40,230,0
236,Ursaring,Normal,90,130,75,55,350,0
237,Slugma,Fire,40,40,40,20,140,0
238,Magcargo,Fire,50,50,120,30,250,0
239,Swinub,Ice,50,50,40,50,190,0
240,Piloswine,Ice,100,100,80,50,330,0
241,Corsola,Water,55,55,85,35,230,0
242,Remoraid,Water,35,65,35,65,200,0
243,Octillery,Water,75,105,75,45,300,0
244,Delibird,Ice,45,55,45,75,220,0
245,Mantine,Water,65,40,70,70,245,0
246,Skarmory,Steel,65,80,140,70,355,0
247,Houndour,Dark,45,60,30,65,200,0
248,Houndoom,Dark,75,90,50,95,310,0
249,HoundoomMega Houndoom,Dark,75,90,90,115,370,0
250,Kingdra,Water,75,95,95,85,350,0
251,Phanpy,Ground,90,60,60,40,250,0
252,Donphan,Ground,90,120,120,50,380,0
253,Porygon2,Normal,85,80,90,60,315,0
254,Stantler,Normal,73,95,62,85,315,0
255,Smeargle,Normal,55,20,35,75,185,0
256,Tyrogue,Fighting,35,35,35,35,140,0
257,Hitmontop,Fighting,50,95,95,70,310,0
258,Smoochum,Ice,45,30,15,65,155,0
259,Elekid,Electric,45,63,37,95,240,0
260,Magby,Fire,45,75,37,83,240,0
261,Miltank,Normal,95,80,105,100,380,0
262,Blissey,Normal,255,10,10,55,330,0
263,Raikou,Electric,90,85,75,115,365,1
264,Entei,Fire,115,115,85,100,415,1
265,Suicune,Water,100,75,115,85,375,1
266,Larvitar,Rock,50,64,50,41,205,0
267,Pupitar,Rock,70,84,70,51,275,0
268,Tyranitar,Rock,100,134,110,61,405,0
269,TyranitarMega Tyranitar,Rock,100,164,150,71,485,0
270,Lugia,Psychic,106,90,130,110,436,1
271,Ho-oh,Fire,106,130,90,90,416,1
272,Celebi,Psychic,100,100,100,100,400,0
273,Treecko,Grass,40,45,35,70,190,0
274,Grovyle,Grass,50,65,45,95,255,0
275,Sceptile,Grass,70,85,65,120,340,0
276,SceptileMega Sceptile,Grass,70,110,75,145,400,0
277,Torchic,Fire,45,60,40,45,190,0
278,Combusken,Fire,60,85,60,55,260,0
279,Blaziken,Fire,80,120,70,80,350,0
280,BlazikenMega Blaziken,Fire,80,160,80,100,420,0
281,Mudkip,Water,50,70,50,40,210,0
282,Marshtomp,Water,70,85,70,50,275,0
283,Swampert,Water,100,110,90,60,360,0
284,SwampertMega Swampert,Water,100,150,110,70,430,0
285,Poochyena,Dark,35,55,35,35,160,0
286,Mightyena,Dark,70,90,70,70,300,0
287,Zigzagoon,Normal,38,30,41,60,169,0
288,Linoone,Normal,78,70,61,100,309,0
289,Wurmple,Bug,45,45,35,20,145,0
290,Silcoon,Bug,50,35,55,15,155,0
291,Beautifly,Bug,60,70,50,65,245,0
292,Cascoon,Bug,50,35,55,15,155,0
293,Dustox,Bug,60,50,70,65,245,0
294,Lotad,Water,40,30,30,30,130,0
295,Lombre,Water,60,50,50,50,210,0
296,Ludicolo,Water,80,70,70,70,290,0
297,Seedot,Grass,40,40,50,30,160,0
298,Nuzleaf,Grass,70,70,40,60,240,0
299,Shiftry,Grass,90,100,60,80,330,0
300,Taillow,Normal,40,55,30,85,210,0
301,Swellow,Normal,60,85,60,125,330,0
302,Wingull,Water,40,30,30,85,185,0
303,Pelipper,Water,60,50,100,65,275,0
304,Ralts,Psychic,28,25,25,40,118,0
305,Kirlia,Psychic,38,35,35,50,158,0
306,Gardevoir,Psychic,68,65,65,80,278,0
307,GardevoirMega Gardevoir,Psychic,68,85,65,100,318,0
308,Surskit,Bug,40,30,32,65,167,0
309,Masquerain,Bug,70,60,62,60,252,0
310,Shroomish,Grass,60,40,60,35,195,0
311,Breloom,Grass,60,130,80,70,340,0
312,Slakoth,Normal,60,60,60,30,210,0
313,Vigoroth,Normal,80,80,80,90,330,0
314,Slaking,Normal,150,160,100,100,510,0
315,Nincada,Bug,31,45,90,40,206,0
316,Ninjask,Bug,61,90,45,160,356,0
317,Shedinja,Bug,1,90,45,40,176,0
318,Whismur,Normal,64,51,23,28,166,0
319,Loudred,Normal,84,71,43,48,246,0
320,Exploud,Normal,104,91,63,68,326,0
321,Makuhita,Fighting,72,60,30,25,187,0
322,Hariyama,Fighting,144,120,60,50,374,0
323,Azurill,Normal,50,20,40,20,130,0
324,Nosepass,Rock,30,45,135,30,240,0
325,Skitty,Normal,50,45,45,50,190,0
326,Delcatty,Normal,70,65,65,70,270,0
327,Sableye,Dark,50,75,75,50,250,0
328,SableyeMega Sableye,Dark,50,85,125,20,280,0
329,Mawile,Steel,50,85,85,50,270,0
330,MawileMega Mawile,Steel,50,105,125,50,330,0
331,Aron,Steel,50,70,100,30,250,0
332,Lairon,Steel,60,90,140,40,330,0
333,Aggron,Steel,70,110,180,50,410,0
334,AggronMega Aggron,Steel,70,140,230,50,490,0
335,Meditite,Fighting,30,40,55,60,185,0
336,Medicham,Fighting,60,60,75,80,275,0
337,MedichamMega Medicham,Fighting,60,100,85,100,345,0
338,Electrike,Electric,40,45,40,65,190,0
339,Manectric,Electric,70,75,60,105,310,0
340,ManectricMega Manectric,Electric,70,75,80,135,360,0
341,Plusle,Electric,60,50,40,95,245,0
342,Minun,Electric,60,40,50,95,245,0
343,Volbeat,Bug,65,73,55,85,278,0
344,Illumise,Bug,65,47,55,85,252,0
345,Roselia,Grass,50,60,45,65,220,0
346,Gulpin,Poison,70,43,53,40,206,0
347,Swalot,Poison,100,73,83,55,311,0
348,Carvanha,Water,45,90,20,65,220,0
349,Sharpedo,Water,70,120,40,95,325,0
350,SharpedoMega Sharpedo,Water,70,140,70,105,385,0
351,Wailmer,Water,130,70,35,60,295,0
352,Wailord,Water,170,90,45,60,365,0
353,Numel,Fire,60,60,40,35,195,0
354,Camerupt,Fire,70,100,70,40,280,0
355,CameruptMega Camerupt,Fire,70,120,100,20,310,0
356,Torkoal,Fire,70,85,140,20,315,0
357,Spoink,Psychic,60,25,35,60,180,0
358,Grumpig,Psychic,80,45,65,80,270,0
359,Spinda,Normal,60,60,60,60,240,0
360,Trapinch,Ground,45,100,45,10,200,0
361,Vibrava,Ground,50,70,50,70,240,0
362,Flygon,Ground,80,100,80,100,360,0
363,Cacnea,Grass,50,85,40,35,210,0
364,Cacturne,Grass,70,115,60,55,300,0
365,Swablu,Normal,45,40,60,50,195,0
366,Altaria,Dragon,75,70,90,80,315,0
367,AltariaMega Altaria,Dragon,75,110,110,80,375,0
368,Zangoose,Normal,73,115,60,90,338,0
369,Seviper,Poison,73,100,60,65,298,0
370,Lunatone,Rock,70,55,65,70,260,0
371,Solrock,Rock,70,95,85,70,320,0
372,Barboach,Water,50,48,43,60,201,0
373,Whiscash,Water,110,78,73,60,321,0
374,Corphish,Water,43,80,65,35,223,0
375,Crawdaunt,Water,63,120,85,55,323,0
376,Baltoy,Ground,40,40,55,55,190,0
377,Claydol,Ground,60,70,105,75,310,0
378,Lileep,Rock,66,41,77,23,207,0
379,Cradily,Rock,86,81,97,43,307,0
380,Anorith,Rock,45,95,50,75,265,0
381,Armaldo,Rock,75,125,100,45,345,0
382,Feebas,Water,20,15,20,80,135,0
383,Milotic,Water,95,60,79,81,315,0
384,Castform,Normal,70,70,70,70,280,0
385,Kecleon,Normal,60,90,70,40,260,0
386,Shuppet,Ghost,44,75,35,45,199,0
387,Banette,Ghost,64,115,65,65,309,0
388,BanetteMega Banette,Ghost,64,165,75,75,379,0
389,Duskull,Ghost,20,40,90,25,175,0
390,Dusclops,Ghost,40,70,130,25,265,0
391,Tropius,Grass,99,68,83,51,301,0
392,Chimecho,Psychic,65,50,70,65,250,0
393,Absol,Dark,65,130,60,75,330,0
394,AbsolMega Absol,Dark,65,150,60,115,390,0
395,Wynaut,Psychic,95,23,48,23,189,0
396,Snorunt,Ice,50,50,50,50,200,0
397,Glalie,Ice,80,80,80,80,320,0
398,GlalieMega Glalie,Ice,80,120,80,100,380,0
399,Spheal,Ice,70,40,50,25,185,0
400,Sealeo,Ice,90,60,70,45,265,0
401,Walrein,Ice,110,80,90,65,345,0
402,Clamperl,Water,35,64,85,32,216,0
403,Huntail,Water,55,104,105,52,316,0
404,Gorebyss,Water,55,84,105,52,296,0
405,Relicanth,Water,100,90,130,55,375,0
406,Luvdisc,Water,43,30,55,97,225,0
407,Bagon,Dragon,45,75,60,50,230,0
408,Shelgon,Dragon,65,95,100,50,310,0
409,Salamence,Dragon,95,135,80,100,410,0
410,SalamenceMega Salamence,Dragon,95,145,130,120,490,0
411,Beldum,Steel,40,55,80,30,205,0
412,Metang,Steel,60,75,100,50,285,0
413,Metagross,Steel,80,135,130,70,415,0
414,MetagrossMega Metagross,Steel,80,145,150,110,485,0
415,Regirock,Rock,80,100,200,50,430,1
416,Regice,Ice,80,50,100,50,280,1
417,Registeel,Steel,80,75,150,50,355,1
418,Latias,Dragon,80,80,90,110,360,1
419,LatiasMega Latias,Dragon,80,100,120,110,410,1
420,Latios,Dragon,80,90,80,110,360,1
421,LatiosMega Latios,Dragon,80,130,100,110,420,1
422,Kyogre,Water,100,100,90,90,380,1
423,KyogrePrimal Kyogre,Water,100,150,90,90,430,1
424,Groudon,Ground,100,150,140,90,480,1
425,GroudonPrimal Groudon,Ground,100,180,160,90,530,1
426,Rayquaza,Dragon,105,150,90,95,440,1
427,RayquazaMega Rayquaza,Dragon,105,180,100,115,500,1
428,Jirachi,Steel,100,100,100,100,400,1
429,DeoxysNormal Forme,Psychic,50,150,50,150,400,1
430,DeoxysAttack Forme,Psychic,50,180,20,150,400,1
431,DeoxysDefense Forme,Psychic,50,70,160,90,370,1
432,DeoxysSpeed Forme,Psychic,50,95,90,180,415,1
433,Turtwig,Grass,55,68,64,31,218,0
434,Grotle,Grass,75,89,85,36,285,0
435,Torterra,Grass,95,109,105,56,365,0
436,Chimchar,Fire,44,58,44,61,207,0
437,Monferno,Fire,64,78,52,81,275,0
438,Infernape,Fire,76,104,71,108,359,0
439,Piplup,Water,53,51,53,40,197,0
440,Prinplup,Water,64,66,68,50,248,0
441,Empoleon,Water,84,86,88,60,318,0
442,Starly,Normal,40,55,30,60,185,0
443,Staravia,Normal,55,75,50,80,260,0
444,Staraptor,Normal,85,120,70,100,375,0
445,Bidoof,Normal,59,45,40,31,175,0
446,Bibarel,Normal,79,85,60,71,295,0
447,Kricketot,Bug,37,25,41,25,128,0
448,Kricketune,Bug,77,85,51,65,278,0
449,Shinx,Electric,45,65,34,45,189,0
450,Luxio,Electric,60,85,49,60,254,0
451,Luxray,Electric,80,120,79,70,349,0
452,Budew,Grass,40,30,35,55,160,0
453,Roserade,Grass,60,70,65,90,285,0
454,Cranidos,Rock,67,125,40,58,290,0
455,Rampardos,Rock,97,165,60,58,380,0
456,Shieldon,Rock,30,42,118,30,220,0
457,Bastiodon,Rock,60,52,168,30,310,0
458,Burmy,Bug,40,29,45,36,150,0
459,WormadamPlant Cloak,Bug,60,59,85,36,240,0
460,WormadamSandy Cloak,Bug,60,79,105,36,280,0
461,WormadamTrash Cloak,Bug,60,69,95,36,260,0
462,Mothim,Bug,70,94,50,66,280,0
463,Combee,Bug,30,30,42,70,172,0
464,Vespiquen,Bug,70,80,102,40,292,0
465,Pachirisu,Electric,60,45,70,95,270,0
466,Buizel,Water,55,65,35,85,240,0
467,Floatzel,Water,85,105,55,115,360,0
468,Cherubi,Grass,45,35,45,35,160,0
469,Cherrim,Grass,70,60,70,85,285,0
470,Shellos,Water,76,48,48,34,206,0
471,Gastrodon,Water,111,83,68,39,301,0
472,Ambipom,Normal,75,100,66,115,356,0
473,Drifloon,Ghost,90,50,34,70,244,0
474,Drifblim,Ghost,150,80,44,80,354,0
475,Buneary,Normal,55,66,44,85,250,0
476,Lopunny,Normal,65,76,84,105,330,0
477,LopunnyMega Lopunny,Normal,65,136,94,135,430,0
478,Mismagius,Ghost,60,60,60,105,285,0
479,Honchkrow,Dark,100,125,52,71,348,0
480,Glameow,Normal,49,55,42,85,231,0
481,Purugly,Normal,71,82,64,112,329,0
482,Chingling,Psychic,45,30,50,45,170,0
483,Stunky,Poison,63,63,47,74,247,0
484,Skuntank,Poison,103,93,67,84,347,0
485,Bronzor,Steel,57,24,86,23,190,0
486,Bronzong,Steel,67,89,116,33,305,0
487,Bonsly,Rock,50,80,95,10,235,0
488,Mime Jr.,Psychic,20,25,45,60,150,0
489,Happiny,Normal,100,5,5,30,140,0
490,Chatot,Normal,76,65,45,91,277,0
491,Spiritomb,Ghost,50,92,108,35,285,0
492,Gible,Dragon,58,70,45,42,215,0
493,Gabite,Dragon,68,90,65,82,305,0
494,Garchomp,Dragon,108,130,95,102,435,0
495,GarchompMega Garchomp,Dragon,108,170,115,92,485,0
496,Munchlax,Normal,135,85,40,5,265,0
497,Riolu,Fighting,40,70,40,60,210,0
498,Lucario,Fighting,70,110,70,90,340,0
499,LucarioMega Lucario,Fighting,70,145,88,112,415,0
500,Hippopotas,Ground,68,72,78,32,250,0
501,Hippowdon,Ground,108,112,118,47,385,0
502,Skorupi,Poison,40,50,90,65,245,0
503,Drapion,Poison,70,90,110,95,365,0
504,Croagunk,Poison,48,61,40,50,199,0
505,Toxicroak,Poison,83,106,65,85,339,0
506,Carnivine,Grass,74,100,72,46,292,0
507,Finneon,Water,49,49,56,66,220,0
508,Lumineon,Water,69,69,76,91,305,0
509,Mantyke,Water,45,20,50,50,165,0
510,Snover,Grass,60,62,50,40,212,0
511,Abomasnow,Grass,90,92,75,60,317,0
512,AbomasnowMega Abomasnow,Grass,90,132,105,30,357,0
513,Weavile,Dark,70,120,65,125,380,0
514,Magnezone,Electric,70,70,115,60,315,0
515,Lickilicky,Normal,110,85,95,50,340,0
516,Rhyperior,Ground,115,140,130,40,425,0
517,Tangrowth,Grass,100,100,125,50,375,0
518,Electivire,Electric,75,123,67,95,360,0
519,Magmortar,Fire,75,95,67,83,320,0
520,Togekiss,Fairy,85,50,95,80,310,0
521,Yanmega,Bug,86,76,86,95,343,0
522,Leafeon,Grass,65,110,130,95,400,0
523,Glaceon,Ice,65,60,110,65,300,0
524,Gliscor,Ground,75,95,125,95,390,0
525,Mamoswine,Ice,110,130,80,80,400,0
526,Porygon-Z,Normal,85,80,70,90,325,0
527,Gallade,Psychic,68,125,65,80,338,0
528,GalladeMega Gallade,Psychic,68,165,95,110,438,0
529,Probopass,Rock,60,55,145,40,300,0
530,Dusknoir,Ghost,45,100,135,45,325,0
531,Froslass,Ice,70,80,70,110,330,0
532,Rotom,Electric,50,50,77,91,268,0
533,RotomHeat Rotom,Electric,50,65,107,86,308,0
534,RotomWash Rotom,Electric,50,65,107,86,308,0
535,RotomFrost Rotom,Electric,50,65,107,86,308,0
536,RotomFan Rotom,Electric,50,65,107,86,308,0
537,RotomMow Rotom,Electric,50,65,107,86,308,0
538,Uxie,Psychic,75,75,130,95,375,1
539,Mesprit,Psychic,80,105,105,80,370,1
540,Azelf,Psychic,75,125,70,115,385,1
541,Dialga,Steel,100,120,120,90,430,1
542,Palkia,Water,90,120,100,100,410,1
543,Heatran,Fire,91,90,106,77,364,1
544,Regigigas,Normal,110,160,110,100,480,1
545,GiratinaAltered Forme,Ghost,150,100,120,90,460,1
546,GiratinaOrigin Forme,Ghost,150,120,100,90,460,1
547,Cresselia,Psychic,120,70,120,85,395,0
548,Phione,Water,80,80,80,80,320,0
549,Manaphy,Water,100,100,100,100,400,0
550,Darkrai,Dark,70,90,90,125,375,1
551,ShayminLand Forme,Grass,100,100,100,100,400,1
552,ShayminSky Forme,Grass,100,103,75,127,405,1
553,Arceus,Normal,120,120,120,120,480,1
554,Victini,Psychic,100,100,100,100,400,1
555,Snivy,Grass,45,45,55,63,208,0
556,Servine,Grass,60,60,75,83,278,0
557,Serperior,Grass,75,75,95,113,358,0
558,Tepig,Fire,65,63,45,45,218,0
559,Pignite,Fire,90,93,55,55,293,0
560,Emboar,Fire,110,123,65,65,363,0
561,Oshawott,Water,55,55,45,45,200,0
562,Dewott,Water,75,75,60,60,270,0
563,Samurott,Water,95,100,85,70,350,0
564,Patrat,Normal,45,55,39,42,181,0
565,Watchog,Normal,60,85,69,77,291,0
566,Lillipup,Normal,45,60,45,55,205,0
567,Herdier,Normal,65,80,65,60,270,0
568,Stoutland,Normal,85,110,90,80,365,0
569,Purrloin,Dark,41,50,37,66,194,0
570,Liepard,Dark,64,88,50,106,308,0
571,Pansage,Grass,50,53,48,64,215,0
572,Simisage,Grass,75,98,63,101,337,0
573,Pansear,Fire,50,53,48,64,215,0
574,Simisear,Fire,75,98,63,101,337,0
575,Panpour,Water,50,53,48,64,215,0
576,Simipour,Water,75,98,63,101,337,0
577,Munna,Psychic,76,25,45,24,170,0
578,Musharna,Psychic,116,55,85,29,285,0
579,Pidove,Normal,50,55,50,43,198,0
580,Tranquill,Normal,62,77,62,65,266,0
581,Unfezant,Normal,80,115,80,93,368,0
582,Blitzle,Electric,45,60,32,76,213,0
583,Zebstrika,Electric,75,100,63,116,354,0
584,Roggenrola,Rock,55,75,85,15,230,0
585,Boldore,Rock,70,105,105,20,300,0
586,Gigalith,Rock,85,135,130,25,375,0
587,Woobat,Psychic,55,45,43,72,215,0
588,Swoobat,Psychic,67,57,55,114,293,0
589,Drilbur,Ground,60,85,40,68,253,0
590,Excadrill,Ground,110,135,60,88,393,0
591,Audino,Normal,103,60,86,50,299,0
592,AudinoMega Audino,Normal,103,60,126,50,339,0
593,Timburr,Fighting,75,80,55,35,245,0
594,Gurdurr,Fighting,85,105,85,40,315,0
595,Conkeldurr,Fighting,105,140,95,45,385,0
596,Tympole,Water,50,50,40,64,204,0
597,Palpitoad,Water,75,65,55,69,264,0
598,Seismitoad,Water,105,95,75,74,349,0
599,Throh,Fighting,120,100,85,45,350,0
600,Sawk,Fighting,75,125,75,85,360,0
601,Sewaddle,Bug,45,53,70,42,210,0
602,Swadloon,Bug,55,63,90,42,250,0
603,Leavanny,Bug,75,103,80,92,350,0
604,Venipede,Bug,30,45,59,57,191,0
605,Whirlipede,Bug,40,55,99,47,241,0
606,Scolipede,Bug,60,100,89,112,361,0
607,Cottonee,Grass,40,27,60,66,193,0
608,Whimsicott,Grass,60,67,85,116,328,0
609,Petilil,Grass,45,35,50,30,160,0
610,Lilligant,Grass,70,60,75,90,295,0
611,Basculin,Water,70,92,65,98,325,0
612,Sandile,Ground,50,72,35,65,222,0
613,Krokorok,Ground,60,82,45,74,261,0
614,Krookodile,Ground,95,117,80,92,384,0
615,Darumaka,Fire,70,90,45,50,255,0
616,DarmanitanStandard Mode,Fire,105,140,55,95,395,0
617,DarmanitanZen Mode,Fire,105,30,105,55,295,0
618,Maractus,Grass,75,86,67,60,288,0
619,Dwebble,Bug,50,65,85,55,255,0
620,Crustle,Bug,70,95,125,45,335,0
621,Scraggy,Dark,50,75,70,48,243,0
622,Scrafty,Dark,65,90,115,58,328,0
623,Sigilyph,Psychic,72,58,80,97,307,0
624,Yamask,Ghost,38,30,85,30,183,0
625,Cofagrigus,Ghost,58,50,145,30,283,0
626,Tirtouga,Water,54,78,103,22,257,0
627,Carracosta,Water,74,108,133,32,347,0
628,Archen,Rock,55,112,45,70,282,0
629,Archeops,Rock,75,140,65,110,390,0
630,Trubbish,Poison,50,50,62,65,227,0
631,Garbodor,Poison,80,95,82,75,332,0
632,Zorua,Dark,40,65,40,65,210,0
633,Zoroark,Dark,60,105,60,105,330,0
634,Minccino,Normal,55,50,40,75,220,0
635,Cinccino,Normal,75,95,60,115,345,0
636,Gothita,Psychic,45,30,50,45,170,0
637,Gothorita,Psychic,60,45,70,55,230,0
638,Gothitelle,Psychic,70,55,95,65,285,0
639,Solosis,Psychic,45,30,40,20,135,0
640,Duosion,Psychic,65,40,50,30,185,0
641,Reuniclus,Psychic,110,65,75,30,280,0
642,Ducklett,Water,62,44,50,55,211,0
643,Swanna,Water,75,87,63,98,323,0
644,Vanillite,Ice,36,50,50,44,180,0
645,Vanillish,Ice,51,65,65,59,240,0
646,Vanilluxe,Ice,71,95,85,79,330,0
647,Deerling,Normal,60,60,50,75,245,0
648,Sawsbuck,Normal,80,100,70,95,345,0
649,Emolga,Electric,55,75,60,103,293,0
650,Karrablast,Bug,50,75,45,60,230,0
651,Escavalier,Bug,70,135,105,20,330,0
652,Foongus,Grass,69,55,45,15,184,0
653,Amoonguss,Grass,114,85,70,30,299,0
654,Frillish,Water,55,40,50,40,185,0
655,Jellicent,Water,100,60,70,60,290,0
656,Alomomola,Water,165,75,80,65,385,0
657,Joltik,Bug,50,47,50,65,212,0
658,Galvantula,Bug,70,77,60,108,315,0
659,Ferroseed,Grass,44,50,91,10,195,0
660,Ferrothorn,Grass,74,94,131,20,319,0
661,Klink,Steel,40,55,70,30,195,0
662,Klang,Steel,60,80,95,50,285,0
663,Klinklang,Steel,60,100,115,90,365,0
664,Tynamo,Electric,35,55,40,60,190,0
665,Eelektrik,Electric,65,85,70,40,260,0
666,Eelektross,Electric,85,115,80,50,330,0
667,Elgyem,Psychic,55,55,55,30,195,0
668,Beheeyem,Psychic,75,75,75,40,265,0
669,Litwick,Ghost,50,30,55,20,155,0
670,Lampent,Ghost,60,40,60,55,215,0
671,Chandelure,Ghost,60,55,90,80,285,0
672,Axew,Dragon,46,87,60,57,250,0
673,Fraxure,Dragon,66,117,70,67,320,0
674,Haxorus,Dragon,76,147,90,97,410,0
675,Cubchoo,Ice,55,70,40,40,205,0
676,Beartic,Ice,95,110,80,50,335,0
677,Cryogonal,Ice,70,50,30,105,255,0
678,Shelmet,Bug,50,40,85,25,200,0
679,Accelgor,Bug,80,70,40,145,335,0
680,Stunfisk,Ground,109,66,84,32,291,0
681,Mienfoo,Fighting,45,85,50,65,245,0
682,Mienshao,Fighting,65,125,60,105,355,0
683,Druddigon,Dragon,77,120,90,48,335,0
684,Golett,Ground,59,74,50,35,218,0
685,Golurk,Ground,89,124,80,55,348,0
686,Pawniard,Dark,45,85,70,60,260,0
687,Bisharp,Dark,65,125,100,70,360,0
688,Bouffalant,Normal,95,110,95,55,355,0
689,Rufflet,Normal,70,83,50,60,263,0
690,Braviary,Normal,100,123,75,80,378,0
691,Vullaby,Dark,70,55,75,60,260,0
692,Mandibuzz,Dark,110,65,105,80,360,0
693,Heatmor,Fire,85,97,66,65,313,0
694,Durant,Bug,58,109,112,109,388,0
695,Deino,Dark,52,65,50,38,205,0
696,Zweilous,Dark,72,85,70,58,285,0
697,Hydreigon,Dark,92,105,90,98,385,0
698,Larvesta,Bug,55,85,55,60,255,0
699,Volcarona,Bug,85,60,65,100,310,0
700,Cobalion,Steel,91,90,129,108,418,1
701,Terrakion,Rock,91,129,90,108,418,1
702,Virizion,Grass,91,90,72,108,361,1
703,TornadusIncarnate Forme,Flying,79,115,70,111,375,1
704,TornadusTherian Forme,Flying,79,100,80,121,380,1
705,ThundurusIncarnate Forme,Electric,79,115,70,111,375,1
706,ThundurusTherian Forme,Electric,79,105,70,101,355,1
707,Reshiram,Dragon,100,120,100,90,410,1
708,Zekrom,Dragon,100,150,120,90,460,1
709,LandorusIncarnate Forme,Ground,89,125,90,101,405,1
710,LandorusTherian Forme,Ground,89,145,90,91,415,1
711,Kyurem,Dragon,125,130,90,95,440,1
712,KyuremBlack Kyurem,Dragon,125,170,100,95,490,1
713,KyuremWhite Kyurem,Dragon,125,120,90,95,430,1
714,KeldeoOrdinary Forme,Water,91,72,90,108,361,0
715,KeldeoResolute Forme,Water,91,72,90,108,361,0
716,MeloettaAria Forme,Normal,100,77,77,90,344,0
717,MeloettaPirouette Forme,Normal,100,128,90,128,446,0
718,Genesect,Bug,71,120,95,99,385,0
719,Chespin,Grass,56,61,65,38,220,0
720,Quilladin,Grass,61,78,95,57,291,0
721,Chesnaught,Grass,88,107,122,64,381,0
722,Fennekin,Fire,40,45,40,60,185,0
723,Braixen,Fire,59,59,58,73,249,0
724,Delphox,Fire,75,69,72,104,320,0
725,Froakie,Water,41,56,40,71,208,0
726,Frogadier,Water,54,63,52,97,266,0
727,Greninja,Water,72,95,67,122,356,0
728,Bunnelby,Normal,38,36,38,57,169,0
729,Diggersby,Normal,85,56,77,78,296,0
730,Fletchling,Normal,45,50,43,62,200,0
731,Fletchinder,Fire,62,73,55,84,274,0
732,Talonflame,Fire,78,81,71,126,356,0
733,Scatterbug,Bug,38,35,40,35,148,0
734,Spewpa,Bug,45,22,60,29,156,0
735,Vivillon,Bug,80,52,50,89,271,0
736,Litleo,Fire,62,50,58,72,242,0
737,Pyroar,Fire,86,68,72,106,332,0
738,Flabébé,Fairy,44,38,39,42,163,0
739,Floette,Fairy,54,45,47,52,198,0
740,Florges,Fairy,78,65,68,75,286,0
741,Skiddo,Grass,66,65,48,52,231,0
742,Gogoat,Grass,123,100,62,68,353,0
743,Pancham,Fighting,67,82,62,43,254,0
744,Pangoro,Fighting,95,124,78,58,355,0
745,Furfrou,Normal,75,80,60,102,317,0
746,Espurr,Psychic,62,48,54,68,232,0
747,MeowsticMale,Psychic,74,48,76,104,302,0
748,MeowsticFemale,Psychic,74,48,76,104,302,0
749,Honedge,Steel,45,80,100,28,253,0
750,Doublade,Steel,59,110,150,35,354,0
751,AegislashBlade Forme,Steel,60,150,50,60,320,0
752,AegislashShield Forme,Steel,60,50,150,60,320,0
753,Spritzee,Fairy,78,52,60,23,213,0
754,Aromatisse,Fairy,101,72,72,29,274,0
755,Swirlix,Fairy,62,48,66,49,225,0
756,Slurpuff,Fairy,82,80,86,72,320,0
757,Inkay,Dark,53,54,53,45,205,0
758,Malamar,Dark,86,92,88,73,339,0
759,Binacle,Rock,42,52,67,50,211,0
760,Barbaracle,Rock,72,105,115,68,360,0
761,Skrelp,Poison,50,60,60,30,200,0
762,Dragalge,Poison,65,75,90,44,274,0
763,Clauncher,Water,50,53,62,44,209,0
764,Clawitzer,Water,71,73,88,59,291,0
765,Helioptile,Electric,44,38,33,70,185,0
766,Heliolisk,Electric,62,55,52,109,278,0
767,Tyrunt,Rock,58,89,77,48,272,0
768,Tyrantrum,Rock,82,121,119,71,393,0
769,Amaura,Rock,77,59,50,46,232,0
770,Aurorus,Rock,123,77,72,58,330,0
771,Sylveon,Fairy,95,65,65,60,285,0
772,Hawlucha,Fighting,78,92,75,118,363,0
773,Dedenne,Electric,67,58,57,101,283,0
774,Carbink,Rock,50,50,150,50,300,0
775,Goomy,Dragon,45,50,35,40,170,0
776,Sliggoo,Dragon,68,75,53,60,256,0
777,Goodra,Dragon,90,100,70,80,340,0
778,Klefki,Steel,57,80,91,75,303,0
779,Phantump,Ghost,43,70,48,38,199,0
780,Trevenant,Ghost,85,110,76,56,327,0
781,PumpkabooAverage Size,Ghost,49,66,70,51,236,0
782,PumpkabooSmall Size,Ghost,44,66,70,56,236,0
783,PumpkabooLarge Size,Ghost,54,66,70,46,236,0
784,PumpkabooSuper Size,Ghost,59,66,70,41,236,0
785,GourgeistAverage Size,Ghost,65,90,122,84,361,0
786,GourgeistSmall Size,Ghost,55,85,122,99,361,0
787,GourgeistLarge Size,Ghost,75,95,122,69,361,0
788,GourgeistSuper Size,Ghost,85,100,122,54,361,0
789,Bergmite,Ice,55,69,85,28,237,0
790,Avalugg,Ice,95,117,184,28,424,0
791,Noibat,Flying,40,30,35,55,160,0
792,Noivern,Flying,85,70,80,123,358,0
793,Xerneas,Fairy,126,131,95,99,451,1
794,Yveltal,Dark,126,131,95,99,451,1
795,Zygarde50% Forme,Dragon,108,100,121,95,424,1
796,Diancie,Rock,50,100,150,50,350,1
797,DiancieMega Diancie,Rock,50,160,110,110,430,1
798,HoopaHoopa Confined,Psychic,80,110,60,70,320,1
799,HoopaHoopa Unbound,Psychic,80,160,60,80,380,1
800,Volcanion,Fire,80,110,120,70,380,1